"135","SCREW M5 X 10 PAN HD PHILIPS","060607C42",200,400,200,200,0.0605,1,0.0605,1228,0,1228,74.294,"2023-06-28 04:33:06","Kanban Stock",2
"136","SCREW M5 X 12 PAN HD PHILIPS","060607C43",200,400,200,200,0.035,1,0.035,1100,600,1700,59.5,"2023-06-28 04:33:06","Kanban Stock",2
"140","SCREW M5 X 25 PAN HD PHILLIPS","060607C46",100,300,100,200,0.067,1,0.067,420,1000,1420,95.14,"2023-06-28 04:33:06","Kanban Stock",2
"93","SCREW M5 X 30 PAN HEAD","060607P47",200,600,200,400,0.0434,1,0.0434,511,1000,1511,65.5774,"2023-06-28 04:33:06","Kanban Stock",2
"155","SCREW M8 X 40 HEX SET 8.8 H/T","060609C30",100,300,100,200,0.1271,1,0.1271,57,1000,1057,134.345,"2023-06-28 04:33:06","Kanban Stock",2
"120","SCREW M10 X 30 HEX SET 8.8 H/T","060609C50",100,300,100,200,0.1295,1,0.1295,53,700,753,97.5135,"2023-06-28 04:33:06","Kanban Stock",2
"124","SCREW M12 X 40 HEX SET 8.8 F/T","060609C82",50,150,50,100,19.09,100,0.1909,86,200,286,54.5974,"2023-06-28 04:33:06","Kanban Stock",2
"146","M6X16 PAN HD PHILIPS","060618C01",400,1200,400,800,0.0605,1,0.0605,499,1200,1699,102.789,"2023-06-28 04:33:06","Kanban Stock",2
"147","6 x 20mm SCREW","15888",400,1200,400,800,5.68,100,0.0568,200,1000,1200,68.16,"2023-06-28 04:33:06","Kanban Stock",2
"130","RIVET BLIND ALUM DOME (ASP-5-2)","18289",1000,2000,1000,1000,0.0182,1,0.0182,550,1000,1550,28.21,"2023-06-28 04:33:06","Kanban Stock",2
"89","4 x 20mm screw","28378",600,1200,600,600,4.24,100,0.0424,413,600,1013,42.9512,"2023-06-28 04:33:06","Kanban Stock",2
"137","SCREW STEEL PAN-HD POZI 5X20MM","28388",400,800,400,400,0.0709,1,0.0709,266,800,1066,75.5794,"2023-06-28 04:33:06","Kanban Stock",2
"109","M8 x 16 Hex Screw","30153",100,200,100,100,8.86,100,0.0886,315,968,1283,113.674,"2023-06-28 04:33:06","Kanban Stock",2
"111","SCREW SET H/T GR8.8 HEX 8x20mm","30154",400,1200,400,800,0.07,1,0.07,199,4000,4199,293.93,"2023-06-28 04:33:06","Kanban Stock",2
"108","SCR-HEX-ISO4017-8.8-WS13-(A2K) - M8x12","30157",100,200,100,100,0.0727,1,0.0727,201,400,601,43.6927,"2023-06-28 04:33:06","Kanban Stock",2
"156","SCREW SET HIGHTENSILE GR8.8 8x50MM","30208",100,300,100,200,12.64,100,0.1264,94,300,394,49.8016,"2023-06-28 04:33:06","Kanban Stock",2
"92","4mm nut","3167",1000,1000,0,1000,0.69,100,0.0069,4493,0,4493,31.0017,"2023-06-28 04:33:06","Kanban Stock",2
"116","8mm Nut","3179",500,2000,500,1500,0.0273,1,0.0273,330,3500,3830,104.559,"2023-06-28 04:33:06","Kanban Stock",2
"122","NUT HEX-STEEL TRIVALENT-ZINC 10MM","3180",400,1200,400,800,0.05,1,0.05,402,1000,1402,70.1,"2023-06-28 04:33:06","Kanban Stock",2
"167","M12 HEX NUT CL 8 ZP","3181",200,600,200,400,0.09,1,0.09,587,700,1287,115.83,"2023-06-28 04:33:06","Kanban Stock",2
"90","4mm Spring Washer","33031",1000,1000,0,1000,0.007,1,0.007,5992,0,5992,41.944,"2023-06-28 04:33:06","Kanban Stock",2
"158","M8 x 3 x 2.0 SPRING WASHER ZP","33042",1500,4500,1500,3000,0.015,1,0.015,985,1729,2714,40.71,"2023-06-28 04:33:06","Kanban Stock",2
"164","WASHER SPRING COIL ZINC (STD) MM 10X3.5X2.2","33045",400,1200,400,800,1.9,100,0.019,774,400,1174,22.306,"2023-06-28 04:33:06","Kanban Stock",2
"179","8MM FL WASHER SS","363400108",250,250,0,250,0.0224,1,0.0224,265,0,265,5.936,"2023-06-28 04:33:06","Kanban Stock",2
"50","SCREW THRD/CUTT TYPE 23 PAN-PH STAIN 4 X 1/4","3665202316",1000,2000,1000,1000,28.84,1000,0.02884,266,0,266,7.67144,"2023-06-28 04:33:06","Kanban Stock",2
"51","Drilling scrw hexagon hd flanged inch SCR-SDM-HWF-WS5/16-(CL2)-12G_14X20","3665202420",500,1000,500,500,0.0909,1,0.0909,386,1500,1886,171.437,"2023-06-28 04:33:06","Kanban Stock",2
"88","SCREW STEEL PAN-HD POZI 4X16MM","41311",400,1200,400,800,0.02,1,0.02,1283,200,1483,29.66,"2023-06-28 04:33:06","Kanban Stock",2
"121","SCREW M10 x 35 SET H/T GR8.8 HEX-HD","415",100,300,100,200,0.1808,1,0.1808,35,150,185,33.448,"2023-06-28 04:33:06","Kanban Stock",2
"145","M6 X 12 HEX SET SCREW CL 8.8 ZINC SILVER","41522",100,200,100,100,0.0409,1,0.0409,194,0,194,7.9346,"2023-06-28 04:33:06","Kanban Stock",2
"123","SCREW SET H/T GR8.8 HEX TRIV.ZINC MM 12X35","432",50,150,50,100,17.65,100,0.1765,61,400,461,81.3665,"2023-06-28 04:33:06","Kanban Stock",2
"94","5mm SPRING WASHER ZP","5891",1000,1000,0,1000,0.008,1,0.008,2988,0,2988,23.904,"2023-06-28 04:33:06","Kanban Stock",2
"127","WASHER SPRING COIL TRIV-480 MM 12X4X2.5","801",400,1200,400,800,3,100,0.03,525,0,525,15.75,"2023-06-28 04:33:06","Kanban Stock",2
"114","M8 X 35 HEX SET SCREW CL 8.8 Z","81835",200,600,200,400,0.1247,1,0.1247,118,1400,1518,189.295,"2023-06-28 04:33:06","Kanban Stock",2
"91","4mm Flat Washer (small)","8344",1000,1000,0,1000,6,1000,0.006,8233,0,8233,49.398,"2023-06-28 04:33:06","Kanban Stock",2
"95","5mm FLAT WASHER 5 x 10 x 1mm","8345",1000,1000,0,1000,0.0074,1,0.0074,4440,0,4440,32.856,"2023-06-28 04:33:06","Kanban Stock",2
"159","WSH-FL-AS1237-BRIGHT-NORMAL- (A2K)-D8 4R","8347",1500,4500,1500,3000,0.015,1,0.015,1886,4800,6686,100.29,"2023-06-28 04:33:06","Kanban Stock",2
"165","10mm Flat washer","8348",400,1200,400,800,2.32,100,0.0232,486,800,1286,29.8352,"2023-06-28 04:33:06","Kanban Stock",2
"126","WASHER FLAT STEEL BRIGHT (STD) ZINC MM 12X24X1.6","8349",400,1200,400,800,3,100,0.03,688,500,1188,35.64,"2023-06-28 04:33:06","Kanban Stock",2
"103","6mm Spring coil Zinc Washer 1/4x1/16/1/16","8691",1000,2000,1000,1000,19.56,1000,0.01956,2018,2200,4218,82.5041,"2023-06-28 04:33:06","Kanban Stock",2
"01","Ferrule Insulated Black 1.50mm","BL015",1500,4500,1500,3000,8.11,500,0.01622,2027,7000,9027,146.418,"2023-06-28 04:33:06","Kanban Stock",2
"03","Ferrule Insulated Grey 2.50mm","BL025",500,1500,500,1000,7.95,500,0.0159,3113,3500,6613,105.147,"2023-06-28 04:33:06","Kanban Stock",2
"04","Ferrule Insulated Grey 2.50mm Long","BL025L",500,1500,500,1000,10.52,500,0.02104,2120,1500,3620,76.1648,"2023-06-28 04:33:06","Kanban Stock",2
"06","Ferrule Insulated Orange 4mm","BL040",500,1500,500,1000,2.82,100,0.0282,1671,3400,5071,143.002,"2023-06-28 04:33:06","Kanban Stock",2
"07","Ferrule 4mm x 18mm Orange","BL040XL",1000,3000,1000,2000,5.3,100,0.053,1445,4500,5945,315.085,"2023-06-28 04:33:06","Kanban Stock",2
"09","Ferrule Insulated Green 6mm","BL060",300,900,300,600,6.02,100,0.0602,1177,1000,2177,131.055,"2023-06-28 04:33:06","Kanban Stock",2
"10","Ferrule Insulated Green 6mm Long","BL060XL",300,900,300,600,4.98,100,0.0498,996,2100,3096,154.181,"2023-06-28 04:33:06","Kanban Stock",2
"12","Ferrule Insulated Brown 10mm","BL100",200,600,200,400,5.02,100,0.0502,587,2400,2987,149.947,"2023-06-28 04:33:06","Kanban Stock",2
"13","Ferrule Brown 10mm2 x 18mm","BL100L",200,600,200,400,6.99,100,0.0699,479,1800,2279,159.302,"2023-06-28 04:33:06","Kanban Stock",2
"14","16mm Ferrule Insulated White","BL160",200,600,200,400,6.99,100,0.0699,446,1900,2346,163.985,"2023-06-28 04:33:06","Kanban Stock",2
"15","Ferrule Insulated White 16mm Long","BL160L",200,600,200,400,7.33,100,0.0733,215,700,915,67.0695,"2023-06-28 04:33:06","Kanban Stock",2
"16","25mm Ferrule Insulated Black","BL250",150,450,150,300,5.65,50,0.113,83,1080,1163,131.419,"2023-06-28 04:33:06","Kanban Stock",2
"17","Ferrule Insulated Black 25mm Long","BL250L",100,300,100,200,7.65,50,0.153,195,750,945,144.585,"2023-06-28 04:33:06","Kanban Stock",2
"18","Ferrule Insulated Red 35mm","BL350",60,180,60,120,2.99,20,0.1495,128,660,788,117.806,"2023-06-28 04:33:06","Kanban Stock",2
"19","Ferrule Insulated Red 35mm Long","BL350L",60,180,60,120,3,20,0.15,143,320,463,69.45,"2023-06-28 04:33:06","Kanban Stock",2
"20","Ferrule Insulated Blue 50mm","BL500",50,150,50,100,3.51,10,0.351,42,140,182,63.882,"2023-06-28 04:33:06","Kanban Stock",2
"21","Ferrule Insulated Yellow 70mm","BL700",40,120,40,80,7.15,10,0.715,27,280,307,219.505,"2023-06-28 04:33:06","Kanban Stock",2
"22","Ferrule Insulated Red 95mm","BL950",20,20,0,20,8.9,10,0.89,40,0,40,35.6,"2023-06-28 04:33:06","Kanban Stock",2
"02","Ferrule Twin Black 2 x 1.5mm","BLT015",500,1500,500,1000,3.7,100,0.037,1160,3000,4160,153.92,"2023-06-28 04:33:06","Kanban Stock",2
"05","Ferrule Twin Grey 2 x 2.5mm","BLT025",500,1500,500,1000,5.7,100,0.057,864,1500,2364,134.748,"2023-06-28 04:33:06","Kanban Stock",2
"08","Ferrule Twin Orange 2 x 4mm","BLT040",200,600,200,400,7.33,100,0.0733,682,1100,1782,130.621,"2023-06-28 04:33:06","Kanban Stock",2
"11","Ferrule Twin Yellow 2 x 6mm","BLT060",100,300,100,200,8.66,100,0.0866,496,500,996,86.2536,"2023-06-28 04:33:06","Kanban Stock",2
"183","M6x16 BOLT","CCCCCC",200,200,0,200,0,0,\N,0,0,0,\N,"2023-06-28 04:33:06","Kanban Stock",2
"68","50 X 8mm LUG","COPY-BIN67",0,0,0,0,1.04,1,1.04,50,0,50,52,"2023-06-28 04:33:06","Kanban Stock",2
"73","70mm Copper Lug 8mm Stud Bell","COPY-BIN72",0,0,0,0,1.33,1,1.33,94,0,94,125.02,"2023-06-28 04:33:06","Kanban Stock",2
"102","M6 x 25 CLINCH STUD ZINC SILVER","CSTUDM625Z",100,100,0,100,0.25,1,0.25,170,0,170,42.5,"2023-06-28 04:33:06","Kanban Stock",2
"110","M8 x 25 CLINCH STUD ZINC SILVER","CSTUDM825Z",100,100,0,100,3,100,0.03,409,0,409,12.27,"2023-06-28 04:33:06","Kanban Stock",2
"55","10mm Copper Lug 10mm Stud Bell","CTL10-10",100,100,0,100,0.31,1,0.31,205,0,205,63.55,"2023-06-28 04:33:06","Kanban Stock",2
"56","10mm Copper Lug 12mm Stud Bell","CTL10-12",100,100,0,100,0.28,1,0.28,101,0,101,28.28,"2023-06-28 04:33:06","Kanban Stock",2
"53","10mm X 6 Copper Lug","CTL10-6",100,100,0,100,0.31,1,0.31,448,0,448,138.88,"2023-06-28 04:33:06","Kanban Stock",2
"54","10 X 8 Copper Lug","CTL10-8",100,100,0,100,0.27,1,0.27,253,400,653,176.31,"2023-06-28 04:33:06","Kanban Stock",2
"79.3","120MM COPPER LUG 10MM STUD BELL","CTL120-10",30,90,30,60,2.19,1,2.19,0,0,0,0,"2023-06-28 04:33:06","Kanban Stock",2
"79.1","120MM COPPER LUG 8MM STUD BELL","CTL120-8",30,90,30,60,2.19,1,2.19,0,0,0,0,"2023-06-28 04:33:06","Kanban Stock",2
"82","150mm Cpr Lug 10mm Stud Bell","CTL150-10",20,80,20,60,4.69,1,4.69,7,100,107,501.83,"2023-06-28 04:33:06","Kanban Stock",2
"81","150mm Copper Lug 8mm Stud Bell","CTL150-8",20,80,20,60,3.02,1,3.02,23,320,343,1035.86,"2023-06-28 04:33:06","Kanban Stock",2
"59","16mm Copper Lug 10mm Stud Bell","CTL16-10",100,300,100,200,0.46,1,0.46,152,650,802,368.92,"2023-06-28 04:33:06","Kanban Stock",2
"57","16mm Copper Lug 6mm Stud Bell","CTL16-6",100,100,0,100,0.32,1,0.32,247,250,497,159.04,"2023-06-28 04:33:06","Kanban Stock",2
"58","16mm Copper Lug 8mm Stud Bell","CTL16-8",200,600,200,400,0.36,1,0.36,99,250,349,125.64,"2023-06-28 04:33:06","Kanban Stock",2
"83.1","185mm Copper Lug 10mm Stud Bell","CTL185-10",20,80,40,40,3.36,1,3.36,0,0,0,0,"2023-06-28 04:33:06","Kanban Stock",2
"85","240mm COPPER LUG 10mm STUD BELL","CTL240-10",10,50,30,20,7.72,1,7.72,10,40,50,386,"2023-06-28 04:33:06","Kanban Stock",2
"62","25mm Copper Lug 10mm Stud Bell","CTL25-10",100,300,100,200,0.5,1,0.5,120,400,520,260,"2023-06-28 04:33:06","Kanban Stock",2
"60","25mm Copper Lug 6mm Stud Bell","CTL25-6",100,100,0,100,0.48,1,0.48,133,400,533,255.84,"2023-06-28 04:33:06","Kanban Stock",2
"61","25mm Copper Lug 8mm Stud Bell","CTL25-8",200,600,200,400,0.44,1,0.44,93,300,393,172.92,"2023-06-28 04:33:06","Kanban Stock",2
"65","35 X 10mm LUG","CTL35-10",100,300,100,200,0.6,1,0.6,121,120,241,144.6,"2023-06-28 04:33:06","Kanban Stock",2
"63","35mm Copper Lug 6mm Stud Bell","CTL35-6",50,50,0,50,0.82,1,0.82,91,360,451,369.82,"2023-06-28 04:33:06","Kanban Stock",2
"64","35mm Copper Lug 8mm Stud Bell","CTL35-8",200,600,200,400,0.77,1,0.77,118,600,718,552.86,"2023-06-28 04:33:06","Kanban Stock",2
"69","50mm Copper Lug 10mm Stud Bell","CTL50-10",100,300,100,200,0.82,1,0.82,85,200,285,233.7,"2023-06-28 04:33:06","Kanban Stock",2
"66","50mm Copper Lug 6mm Stud Bell","CTL50-6",100,100,0,100,1.05,1,1.05,96,100,196,205.8,"2023-06-28 04:33:06","Kanban Stock",2
"67","50 X 8mm LUG","CTL50-8",400,1200,400,800,1.04,1,1.04,48,340,388,403.52,"2023-06-28 04:33:06","Kanban Stock",2
"52","6mm x 8 Copper Lug","CTL6-8",100,100,0,100,0.21,1,0.21,2197,0,2197,461.37,"2023-06-28 04:33:06","Kanban Stock",2
"74","70mm Copper Lug 10mm Stud Bell","CTL70-10",50,150,50,100,1.12,1,1.12,38,100,138,154.56,"2023-06-28 04:33:06","Kanban Stock",2
"70","70mm Copper Lug 6mm Stud Bell","CTL70-6",50,50,0,50,0.84,1,0.84,86,160,246,206.64,"2023-06-28 04:33:06","Kanban Stock",2
"72","70mm Copper Lug 8mm Stud Bell","CTL70-8",200,600,200,400,1.33,1,1.33,37,400,437,581.21,"2023-06-28 04:33:06","Kanban Stock",2
"78","95MM COPPER LUG 10MM STUD BELL","CTL95-10",60,180,60,120,1.93,1,1.93,31,320,351,677.43,"2023-06-28 04:33:06","Kanban Stock",2
"76","95MM COPPER LUG 10MM STUD BELL","CTL95-8",60,240,120,120,1.42,1,1.42,31,200,231,328.02,"2023-06-28 04:33:06","Kanban Stock",2
"80","Narrow Palm Lug 120-10mm","CTLNP120-10",50,50,0,50,4.35,1,4.35,20,210,230,1000.5,"2023-06-28 04:33:06","Kanban Stock",2
"79.2","NARROW PALM LUG 120-8mm","CTLNP120-8",30,90,30,60,3.05,1,3.05,0,0,0,0,"2023-06-28 04:33:06","Kanban Stock",2
"83","Narrow Palm Lug 150-10mm","CTLNP150-10",20,60,20,40,5.7,1,5.7,30,100,130,741,"2023-06-28 04:33:06","Kanban Stock",2
"82.1","NARROW PALM LUG 150-8mm","CTLNP150-8",20,60,20,40,3.95,1,3.95,0,0,0,0,"2023-06-28 04:33:06","Kanban Stock",2
"84","Narrow Palm Lug 185-10mm","CTLNP185-10",20,80,40,40,4.45,1,4.45,12,100,112,498.4,"2023-06-28 04:33:06","Kanban Stock",2
"86","Narrow Palm Lug 240-10mm","CTLNP240-10",10,50,30,20,6.97,1,6.97,7,70,77,536.69,"2023-06-28 04:33:06","Kanban Stock",2
"75","Narrow Palm Lug 70-10mm","CTLNP70-10",100,100,0,100,2.24,1,2.24,60,0,60,134.4,"2023-06-28 04:33:06","Kanban Stock",2
"71","Narrow Palm Lug 70-6mm","CTLNP70-6",50,50,0,50,1.71,1,1.71,29,0,29,49.59,"2023-06-28 04:33:06","Kanban Stock",2
"79","95 x 10mm NARROW PALM LUG","CTLNP95-10",50,50,0,50,2.46,1,2.46,56,0,56,137.76,"2023-06-28 04:33:06","Kanban Stock",2
"77","NARROW PALM LUG 95-8mm","CTLNP95-8",60,180,60,120,2.56,1,2.56,33,250,283,724.48,"2023-06-28 04:33:06","Kanban Stock",2
"105","105-empty","Empty105",0,0,0,0,0,0,\N,0,0,0,\N,"2023-06-28 04:33:06","Kanban Stock",2
"184","EMPTY184","EMPTY184",0,0,0,0,0,0,\N,0,0,0,\N,"2023-06-28 04:33:06","Kanban Stock",2
"185","EMPTY185","EMPTY185",0,0,0,0,0,0,\N,0,0,0,\N,"2023-06-28 04:33:06","Kanban Stock",2
"186","EMPTY186","EMPTY186",0,0,0,0,0,0,\N,0,0,0,\N,"2023-06-28 04:33:06","Kanban Stock",2
"187","EMPTY187","EMPTY187",0,0,0,0,0,0,\N,0,0,0,\N,"2023-06-28 04:33:06","Kanban Stock",2
"188","EMPTY188","EMPTY188",0,0,0,0,0,0,\N,0,0,0,\N,"2023-06-28 04:33:06","Kanban Stock",2
"189","EMPTY189","EMPTY189",0,0,0,0,0,0,\N,0,0,0,\N,"2023-06-28 04:33:06","Kanban Stock",2
"190","EMPTY190","EMPTY190",0,0,0,0,0,0,\N,0,0,0,\N,"2023-06-28 04:33:06","Kanban Stock",2
"30","BLADE RED 10mm COPPER SLEEVE","FB1-10CS",200,600,200,400,6.43,100,0.0643,1391,3500,4891,314.491,"2023-06-28 04:33:06","Kanban Stock",2
"38","BLADE BLUE 13MM COPPER SLEEVE","FB2-13CS",100,300,100,200,8.08,100,0.0808,1102,500,1602,129.442,"2023-06-28 04:33:06","Kanban Stock",2
"45","Blade Yellow 10mm Copper Sleeve","FB5-10CS",100,100,0,100,9.3,100,0.093,51,0,51,4.743,"2023-06-28 04:33:06","Kanban Stock",2
"44","Blade Yellow 18mm Copper Sleeve","FB5-18CS",100,100,0,100,12.24,100,0.1224,500,0,500,61.2,"2023-06-28 04:33:06","Kanban Stock",2
"170","M10 X 25 GRUB SCREW","GSM1025P",100,100,0,100,0.3091,100,0.003091,407,0,407,1.25804,"2023-06-28 04:33:06","Kanban Stock",2
"168","M6 X 25 GRUB SCREW","GSM625P",200,200,0,200,0.1545,100,0.001545,312,80,392,0.60564,"2023-06-28 04:33:06","Kanban Stock",2
"169","M8 X 25 GRUB SCREW","GSM825P",200,200,0,200,0.2091,100,0.002091,392,500,892,1.86517,"2023-06-28 04:33:06","Kanban Stock",2
"182","M5x65 PAN SCREW","LLLLLL",50,50,0,50,0,0,\N,0,0,0,\N,"2023-06-28 04:33:06","Kanban Stock",2
"87","M4 x 10 MACHINE SCREW CHEESE SLOT ZP","MTM410CHSZ",500,1500,500,1000,0.0364,1,0.0364,386,600,986,35.8904,"2023-06-28 04:33:06","Kanban Stock",2
"139","M5 X 20 PAN PHIL METAL THREAD","MTM520CXZ",400,800,400,400,0.0473,1,0.0473,683,800,1483,70.1459,"2023-06-28 04:33:06","Kanban Stock",2
"141","M5 X 30 PAN PHIL METAL THREAD","MTM530CXZ",100,300,100,200,0.0434,1,0.0434,566,1000,1566,67.9644,"2023-06-28 04:33:06","Kanban Stock",2
"151","M6 X 20 MACHINE SCREWS PAN SLO","MTM620PSBR",200,200,0,200,0.1046,1,0.1046,400,1000,1400,146.44,"2023-06-28 04:33:06","Kanban Stock",2
"152","M6 X 30 MACHINE SCREWS PAN ","MTM630PSBR",200,200,0,200,0.9,1,0.9,202,800,1002,901.8,"2023-06-28 04:33:06","Kanban Stock",2
"101","M6 X 40 PAN PHIL METAL THREAD","MTM640PXZ",100,100,0,100,13.18,100,0.1318,210,1000,1210,159.478,"2023-06-28 04:33:06","Kanban Stock",2
"144","5MM BRASS NUT","NM5BR",250,250,0,250,0.1112,1,0.1112,842,0,842,93.6304,"2023-06-28 04:33:06","Kanban Stock",2
"97","M5 HEX NUT ZP","NM5Z",500,500,0,500,0.018,1,0.018,1568,3000,4568,82.224,"2023-06-28 04:33:06","Kanban Stock",2
"154","6MM BRASS NUT","NM6BR",150,150,0,150,0.1762,1,0.1762,789,400,1189,209.502,"2023-06-28 04:33:06","Kanban Stock",2
"107","6mm nut","NM6Z",500,1500,500,1000,0.0227,1,0.0227,985,2250,3235,73.4345,"2023-06-28 04:33:06","Kanban Stock",2
"180","8MM NUT SS","NM8S",250,250,0,250,0.0664,1,0.0664,244,0,244,16.2016,"2023-06-28 04:33:06","Kanban Stock",2
"131","RIVET BLIND ALUM DOME (ASP-5-4)","RAS54",500,1500,500,1000,0.0211,1,0.0211,481,2000,2481,52.3491,"2023-06-28 04:33:06","Kanban Stock",2
"133","6 - 12 Rivet","RAS612",250,250,0,250,0.0573,1,0.0573,204,300,504,28.8792,"2023-06-28 04:33:06","Kanban Stock",2
"132","RIVET ALUMINIUM STEEL STEM 6-8","RAS68",500,1500,500,1000,0.0359,1,0.0359,151,3000,3151,113.121,"2023-06-28 04:33:06","Kanban Stock",2
"31","Ring Red 8mm","RL1-8",300,900,300,600,5.68,100,0.0568,795,3600,4395,249.636,"2023-06-28 04:33:06","Kanban Stock",2
"36","Round Lug Ring Blue 6mm","RL2-6",300,900,300,600,5.9,100,0.059,676,4000,4676,275.884,"2023-06-28 04:33:06","Kanban Stock",2
"37","RING TERMANAL STD 1.04-2.63mm","RL2-8",300,900,300,600,5.1,100,0.051,264,300,564,28.764,"2023-06-28 04:33:06","Kanban Stock",2
"42","Ring Yellow 10mm Copper Sleeve","RL5-10CS",100,100,0,100,19.76,100,0.1976,167,0,167,32.9992,"2023-06-28 04:33:06","Kanban Stock",2
"43","Ring Yellow 12mm Copper Sleeve","RL5-12CS",100,100,0,100,19.4,100,0.194,390,0,390,75.66,"2023-06-28 04:33:06","Kanban Stock",2
"39","Ring Yellow 5mm Copper Sleeve","RL5-5CS",100,300,100,200,15.11,100,0.1511,525,400,925,139.768,"2023-06-28 04:33:06","Kanban Stock",2
"40","Ring Yellow 6mm Copper Sleeve","RL5-6CS",400,1200,400,800,18.01,100,0.1801,242,1500,1742,313.734,"2023-06-28 04:33:06","Kanban Stock",2
"41","Ring Yellow 8mm Copper Sleeve","RL5-8CS",400,1200,400,800,21.44,100,0.2144,371,3800,4171,894.262,"2023-06-28 04:33:06","Kanban Stock",2
"48.2","M8 X 25 MM SOCKET HEAD CAP SCREW CL 12.9 ZP","SHCSM825Z",100,300,100,200,0.1476,1,0.1476,232,400,632,93.2832,"2023-06-28 04:33:06","Kanban Stock",2
"26","Spade Red 3mm","SL1-3",100,300,100,200,3.84,100,0.0384,1017,1300,2317,88.9728,"2023-06-28 04:33:06","Kanban Stock",2
"27","Spade Red 3.5mm","SL1-3.5",200,600,200,400,3.86,100,0.0386,1247,1500,2747,106.034,"2023-06-28 04:33:06","Kanban Stock",2
"28","Spade Red 5mm","SL1-5",200,600,200,400,4.73,100,0.0473,669,600,1269,60.0237,"2023-06-28 04:33:06","Kanban Stock",2
"29","SPADE RED 6MM","SL1-6",200,600,200,400,5.61,100,0.0561,970,2000,2970,166.617,"2023-06-28 04:33:06","Kanban Stock",2
"32","Spade Blue 3mm","SL2-3",200,600,200,400,4.69,100,0.0469,856,0,856,40.1464,"2023-06-28 04:33:06","Kanban Stock",2
"33","Spade Blue 3mm","SL2-3.5",200,600,200,400,4.57,100,0.0457,935,2100,3035,138.7,"2023-06-28 04:33:06","Kanban Stock",2
"34","Spade Blue 5mm","SL2-5",200,600,200,400,3.85,100,0.0385,0,100,100,3.85,"2023-06-28 04:33:06","Kanban Stock",2
"35","Spade Blue 6mm Copper Sleeve","SL2-6CS",100,100,0,100,7.66,100,0.0766,81,0,81,6.2046,"2023-06-28 04:33:06","Kanban Stock",2
"48.1","Spade Yellow 5mm","SL5-5",100,100,0,100,9.91,100,0.0991,0,0,0,0,"2023-06-28 04:33:06","Kanban Stock",2
"163","M10 X 120MM SCREW","SSM10120ZP",50,150,50,100,1,1,1,66,100,166,166,"2023-06-28 04:33:06","Kanban Stock",2
"117","M10 X 16 Hex Crew","SSM1016Z8",100,300,100,200,0.1358,1,0.1358,205,400,605,82.159,"2023-06-28 04:33:06","Kanban Stock",2
"118","M10 X 20 HEX SET SCREW CL 8.8","SSM1020Z8",100,300,100,200,0.1241,1,0.1241,198,300,498,61.8018,"2023-06-28 04:33:06","Kanban Stock",2
"119","M10 X 25 HEX SET SCREW CL 8.8 ZINC SILVER","SSM1025Z8",100,300,100,200,0.1545,1,0.1545,123,450,573,88.5285,"2023-06-28 04:33:06","Kanban Stock",2
"161","M10 X 40MM SCREW","SSM1040Z8",100,300,100,200,0.2,1,0.2,100,450,550,110,"2023-06-28 04:33:06","Kanban Stock",2
"162","M10 X 50MM SCREW","SSM1050ZP",100,300,100,200,0.2,1,0.2,78,225,303,60.6,"2023-06-28 04:33:06","Kanban Stock",2
"125","SCREW M12 X 45 HEX SET 8.8 F/T","SSM1245Z8",50,150,50,100,0.3,1,0.3,58,450,508,152.4,"2023-06-28 04:33:06","Kanban Stock",2
"138","M5 x 20 Screw","SSM520Z8",200,400,200,200,0.0605,1,0.0605,627,0,627,37.9335,"2023-06-28 04:33:06","Kanban Stock",2
"148","6 X 25MM HEX HEAD SCREW","SSM625Z8",300,900,300,600,0.0424,1,0.0424,295,800,1095,46.428,"2023-06-28 04:33:06","Kanban Stock",2
"100","6 X 30MM HEX HEAD SCREW","SSM630Z8",200,200,0,200,0.9,1,0.9,62,0,62,55.8,"2023-06-28 04:33:06","Kanban Stock",2
"134","M8 x 25 Stailess Steel Bolts","SSM825S",100,100,0,100,0.1818,1,0.1818,134,400,534,97.0812,"2023-06-28 04:33:06","Kanban Stock",2
"112","M8 X 25 HEX SET SCREW CL 8.8 Z","SSM825Z8",400,1200,400,800,0.0766,1,0.0766,255,1200,1455,111.453,"2023-06-28 04:33:06","Kanban Stock",2
"113","M8X30 SET SCREW","SSM830Z8",200,600,200,400,0.07,1,0.07,197,2000,2197,153.79,"2023-06-28 04:33:06","Kanban Stock",2
"174","M8 X 45MM SCREW","SSM845S",250,250,0,250,0.1318,1,0.1318,137,700,837,110.317,"2023-06-28 04:33:06","Kanban Stock",2
"157","M8 X 75 HEX SET SCREW CL 8.8 ZINC SILVER","SSM875Z8",50,150,50,100,0.2273,1,0.2273,56,200,256,58.1888,"2023-06-28 04:33:06","Kanban Stock",2
"129","10G X 1 IN PAN XR SELF TAPPING","ST101PXZ",1000,3000,1000,2000,0.03,1,0.03,872,2000,2872,86.16,"2023-06-28 04:33:06","Kanban Stock",2
"49","SELF TAPPER 10G X ¾(20MM) PAN XR PHILLIPS ZINC","ST1034PXZ",1000,1000,1000,0,0.03,1,0.03,886,0,886,26.58,"2023-06-28 04:33:06","Kanban Stock",2
"173","8G X 1 IN PAN XR SELF TAPPING SCREW ZP","ST81PXZ",1000,1000,0,1000,27.3,1000,0.0273,778,2000,2778,75.8394,"2023-06-28 04:33:06","Kanban Stock",2
"171","SCREW 8-18 X 12 METAL SDS BUTTON WAFER HEAD","TSB812ZY",1000,3000,1000,2000,0.022,1,0.022,1000,2000,3000,66,"2023-06-28 04:33:06","Kanban Stock",2
"172","12mm SADDLE MOUNTING SCREW","TSP8127",1000,2000,1000,1000,1,100,0.01,1013,0,1013,10.13,"2023-06-28 04:33:06","Kanban Stock",2
"181","Self Tapping Screw 5mm x 12","TTM512PZZ",500,500,0,500,0.12,1,0.12,2016,0,2016,241.92,"2023-06-28 04:33:06","Kanban Stock",2
"23","Ferrule Uninsulated 10mm long","UBL100L",100,100,0,100,0.51,10,0.051,832,0,832,42.432,"2023-06-28 04:33:06","Kanban Stock",2
"24","Ferrule Uninsulated 16mm long","UBL160L",100,100,0,100,0.7,10,0.07,448,0,448,31.36,"2023-06-28 04:33:06","Kanban Stock",2
"25","Ferrule Uninsulated 25mm long","UBL250L",100,100,0,100,1.01,10,0.101,195,0,195,19.695,"2023-06-28 04:33:06","Kanban Stock",2
"106","WASHER FLAT ROUND ZINC 6mm (1/4)","WASHM6ZP",400,800,400,400,0.0426,1,0.0426,1440,7500,8940,380.844,"2023-06-28 04:33:06","Kanban Stock",2
"46","WASHER LOAD M8X 18 X 2 HDS Z/P","WBM8182Z",1000,3000,1000,2000,0.2,1,0.2,367,3000,3367,673.4,"2023-06-28 04:33:06","Kanban Stock",2
"98","5MM EXTERNAL TOOTH WASHER ZP","WETM5Z",500,500,0,500,0.011,1,0.011,2143,0,2143,23.573,"2023-06-28 04:33:06","Kanban Stock",2
"149","6MM EXTERNAL TOOTH WASHER ZP ","WETM6Z",1000,1000,0,1000,0.02,1,0.02,1157,0,1157,23.14,"2023-06-28 04:33:06","Kanban Stock",2
"96","3/16X1/2X20G FLAT WASHER ZP","WF3161220Z",1000,3000,1000,2000,0.0118,1,0.0118,2166,3400,5566,65.6788,"2023-06-28 04:33:06","Kanban Stock",2
"160","5/16 X 1 1/4 X 16G FLAT WASHER","WF51611416Z",600,1800,600,1200,0.0667,1,0.0667,202,3600,3802,253.593,"2023-06-28 04:33:06","Kanban Stock",2
"143","5mm Brass Flat Washer","WFM5BR",500,500,0,500,0.0441,1,0.0441,2251,0,2251,99.2691,"2023-06-28 04:33:06","Kanban Stock",2
"153","6MM FL BR WASHER","WFM6BR",300,300,0,300,0.0818,1,0.0818,1596,0,1596,130.553,"2023-06-28 04:33:06","Kanban Stock",2
"178","6MM FL WASHER SS","WFM6S",250,250,0,250,0.0136,1,0.0136,739,0,739,10.0504,"2023-06-28 04:33:06","Kanban Stock",2
"104","M6 X 12.5 X 1.2 FLAT WASHER ZP","WFM6Z",1000,2000,1000,1000,0,0,\N,2221,3400,5621,\N,"2023-06-28 04:33:06","Kanban Stock",2
"166","Lockwasher 10mm internal","WITM10Z",1000,1000,0,1000,0.0455,1,0.0455,942,0,942,42.861,"2023-06-28 04:33:06","Kanban Stock",2
"99","5MM INTERNAL TOOTH WASHER ZP","WITM5Z",500,500,0,500,0.0152,1,0.0152,2262,0,2262,34.3824,"2023-06-28 04:33:06","Kanban Stock",2
"150","6MM INTERNAL TOOTH WASHER ZP ","WITM6Z",1000,1000,0,1000,0.017,1,0.017,1695,0,1695,28.815,"2023-06-28 04:33:06","Kanban Stock",2
"115","8MM INTERNAL TOOTH WASHER ZP","WITM8Z",1000,1000,0,1000,0.0306,1,0.0306,2352,3000,5352,163.771,"2023-06-28 04:33:06","Kanban Stock",2
"47","WASHER LOAD M10 X 23 X 2.5 HDS Z/P","WLM10Z",500,1500,500,1000,0.3,1,0.3,286,500,786,235.8,"2023-06-28 04:33:06","Kanban Stock",2
"48","WASHER LOAD M12","WLM12Z",150,450,150,300,0.606,1,0.606,61,600,661,400.566,"2023-06-28 04:33:06","Kanban Stock",2
"177","10MM SP WASHER SS","WSM10S",250,250,0,250,0.0415,1,0.0415,644,0,644,26.726,"2023-06-28 04:33:06","Kanban Stock",2
"175","6MM SP WASHER SS","WSM6S",250,250,0,250,0.0148,1,0.0148,6821,0,6821,100.951,"2023-06-28 04:33:06","Kanban Stock",2
"176","8MM SP WASHER SS","WSM8S",250,250,0,250,0.0258,1,0.0258,3300,0,3300,85.14,"2023-06-28 04:33:06","Kanban Stock",2
"142","5mm Brass Spring Washer","xxxx",500,500,0,500,0.0441,1,0.0441,38,0,38,1.6758,"2023-06-28 04:33:06","Kanban Stock",2
"128","25mm Flat Head Screw ( Temp E&N Screw)","xxxxxxx",0,0,0,0,1,100,0.01,753,0,753,7.53,"2023-06-28 04:33:06","Kanban Stock",2
